NO textures/ice.xpm
SO textures/lava.xpm
WE textures/bricks.xpm
EA textures/leaves.xpm

F 101,183,65
C 123,211,234

       
       
        
                
  1111111111
  1000000001
  100S000001  11
  1000000001  11     
  1100010101
   1000010111
  1100000001
  1111111111
    
